11111111111
1000P001001
1000C00C001
10000100E01
1000E000001
11111111111